CpteCilent=Client account
custpackiExport=Batch Slip Journal Export 
error=Insert Error
ErrorConSftp=Error connecting to SFTP server
ExtItemMatch=The client want to order item %1
FError=File XML Error
Fieldxml=Group Champs XML
FileLoad=Load XML File Error
FileLoaded=file loaded
FileXMLRecieved=File XML Recieved 
 ;Label file comment - see above label
FileXMLTraited=File XML traited
FXMLImpParam=Setup File XML import
host=Host
ImportXML=Import xml parameters
ItemExist=Item %1 does exist in InventTable. You may proceed.
NoCust=Customer %1 does not exist in the database.
NoHeadMatch=Worksordernumber does not match the header
NoItem=Item %1 does not exist in InventTable.
NoRecFound=No Record found in EDIImportXMLtable:Customer account not found.
NotEngelvart=Works order number %1 should not be repeated
NotEngelvartFormat=The imported file is not an ENGELVART XML file. Please check your files.
OrdCreaSucc=Client orders created successfully.
OrdExist=order %1 already exist, cannot be inserted twice.
OrdIns=order %1 and sales line inserted
port=Port
Projob=Process Job
Repo=Repository
ServerSFTPparm=SFTP Server
ServPassword=Password
servSFTP=SFTP server
SFTPservTab=SFTPserverTable
username=Username
