CpteCilent=compte client
custpackiExport=Exporter des bons de livraison en lot
error=Erreur d'insertion 
ExtItemMatch=le client veut commander l'article %1
FError=fichier XML erroné
Fieldxml=Field Group XML
FileLoad=Probléme de téléchargement de fichier xml
FileLoaded=Fichier téléchargé
FileXMLRecieved=fichier XML reçu
 ;Label file comment - see above label
FileXMLTraited=fichier XML traité
FXMLImpParam=Paramétrer l'import des fichiers XML
host=Host
ImportXML=Pramètre Import xml
ItemExist=L'élément %1 existe dans InventTable. Vous pouvez continuer.
NoCust=Le client %1 n'existe pas dans la base de données.
NoHeadMatch=Le numéro de commande ne correspond pas à l'en-tête
NoItem=L'élément %1 n'existe pas dans InventTable.
NoRecFound=Aucun enregistrement trouvé dans EDIImportXMLtable : compte client introuvable.
NotEngelvart=Le numéro de commande %1 de travaux ne doit pas être répété.
NotEngelvartFormat=Le fichier importé n'est pas un fichier XML ENGELVART. Veuillez vérifier vos fichiers.
OrdCreaSucc=Commandes client créées avec succès.
OrdExist=La commande %1 existe déjà, ne peut pas être insérée deux fois.
OrdIns=commande %1 et ligne de vente insérées.
port=Port
Projob=Process Job
Repo=Répertoire
ServerSFTPparm=Serveur SFTP
ServPassword=Mot de passe
servSFTP=serveur SFTP
SFTPservTab=SFTPserverTable
username=Nom d'utilisateur
